 ##### ######### ############# #########
#....o#.........#.............#.........#
#.#####.#######.#.#######.###.#.#####.##
#.............#...#.#...#...#.......#...#
 ##############.###.#.#.###.#######.###.#
#.........#...#.....#.#.#...#.....#...#.#
#.#######.#.#.#####.#.#.#####.###.#####.#
#...#.....#.#.....#.#.#.#.....#.#...#...#
#.#.#.#####.#####.###.#.#.#####.###.#.#.#
#.#.#.......#...#.#...#.#.#.#.....#...#.#
#.#.#########.###.#.###.#.#.#.###.#####.#
#.#.#...#.....#...#...#...#...#...#.....#
#.#.#.#.###.#.#.## ##.#####.###.#.#.####
#.#...#...#.#.#...#...#...#.#...#.#...#.#
#.#######.#.#.###.#.###.#.#.#.#.#####.#.#
#...#.....#.#.....#...#.#.#.#.#.#...#...#
 ####.#####.#########.#.#.###.###.#.###.#
#.....#...#...#.......#.#.#...#...#.....#
#.#####.#.###.#.#######.#.#.#.#.## #####
#...#...#.......#...#...#...#.#...#.....#
 ##.#.#####.#####.#.###.#####.###.#.###.#
#...#.#...#...#...#..@#.#...#...#.#...#.#
#.#####.#.#####.#######.#.#.###.#.#.#.#.#
#.#.....#.......#.....#...#.#...#.#.#.#.#
#.#.#############.#.###.###.#.###.###.##
#.#.#...........#.#.....#...#...#...#...#
#.#.#.#######.###.#######.#####.###.###.#
#.#.#.......#.#...#.#...#.....#...#.#...#
#.#.#####.###.#.###.#.#.###.#.###.#.#.#.#
#.#.....#.#...#.#...#.#...#.#...#.#...#.#
#.#####.###.#.#.###.#.###.#####.#######.#
#...#...#...#.#...#.#...#.....#.....#...#
 ##.#.###.#######.#.###.#####.###.###.##
#.#...#...#.....#.#...#.#...#.....#...#.#
#.#####.#.#.###.#.###.#.#.#.#####.#.###.#
#.....#.#...#...#...#.#...#...#...#.....#
#.#####.#####.## ##.#.#### ##.#.#######.#
#.......#...#...#...#.....#...#.......#.#
#.#######.#.###.#.#######.#.###########.#
#.........#...#...........#.............#
 ######### ### ########### #############
