 ##### ######### ############# ##########
#....o#.........#.............#.........#
#.#####.#######.#.#######.###.#.#####.###
#.............#...#.#...#...#.......#...#
 ##############.###.#.#.###.#######.###.#
#.........#...#.....#.#.#...#.....#...#.#
#.#######.#.#.#####.#.#.#####.###.#####.#
#...#.....#.#.....#.#.#.#.....#.#...#...#
#.#.#.#####.#####.###.#.#.#####.###.#.#.#
#.#.#.......#...#.#...#.#.#.#.....#...#.#
#.#.#########.###.#.###.#.#.#.###.#####.#
#.#.#...#.....#...#...#...#...#...#.....#
#.#.#.#.###.#.#.## ##.#####.###.#.#.#####
#.#...#...#.#.#...#...#...#.#...#.#...#.#
#.#######.#.#.###.#.###.#.#.#.#.#####.#.#
#...#.....#.#.....#...#.#.#.#.#.#...#...#
 ####.#####.#########.#.#.###.###.#.###.#
#.....#...#...#.......#.#.#...#...#.....#
#.#####.#.###.#.#######.#.#.#.#.## ######
#...#...#.......#...#...#...#.#...#.....#
 ##.#.#####.#####.#.###.#####.###.#.###.#
#...#.#...#...#...#..@#.#...#...#.#...#.#
#.#####.#.#####.#######.#.#.###.#.#.#.#.#
#.#.....#.......#.....#...#.#...#.#.#.#.#
#.#.#############.#.###.###.#.###.###.###
#.#.#...........#.#.....#...#...#...#...#
#.#.#.#######.###.#######.#####.###.###.#
#.#.#.......#.#...#.#...#.....#...#.#...#
#.#.#####.###.#.###.#.#.###.#.###.#.#.#.#
#.#.....#.#...#.#...#.#...#.#...#.#...#.#
#.#####.###.#.#.###.#.###.#####.#######.#
#...#...#...#.#...#.#...#.....#.....#...#
 ##.#.###.#######.#.###.#####.###.###.###
#.#...#...#.....#.#...#.#...#.....#...#.#
#.#####.#.#.###.#.###.#.#.#.#####.#.###.#
#.....#.#...#...#...#.#...#...#...#.....#
#.#####.#####.## ##.#.#### ##.#.#######.#
#.......#...#...#...#.....#...#.......#.#
#.#######.#.###.#.#######.#.###########.#
#.........#...#...........#.............#
 ######### ### ########### ##############
